1111111111111111111111111111111111111111111111111111
1110111110001100100110001110101101110110110010000101
1000011010101011111001101110000110010110011001001111
1001100111011100101101011001000010001001010011111101
1101011101001110011000001110010100000000111001100001
1011100111110101110110011000100100100110000111110101
1100100111010110010011100111100101100110011001010001
1000011011111011001011001010011101011110111100101111
1111110001001001010101110001010011011110001100000011
1111001110100101000111001001001011101011000000101001
1000111100111101011111000001111000001010001100110001
1110001000110000010100011000010110100001011110110001
1111101100101101111100000110100111010100100001111001
1101001111010000110111010110111100001101001010111001
1011000000010110000111100100011011110001110001001111
1100011110011000101001010101000010100001010100101011
1111001101000100000011110011111000001000000110101001
1110010100111111101111100101111000101001110010011001
1111111011111110100111101010111001100010101010100001
1011001101000121001110111010111001100100110111001111
1000101000010100110011110001111000001001001001000111
1101111011001101000000001001111011111110110010000111
1001111010110100111111111110000110100101111010001111
1000111101111000010100101100001001011010111000100111
1010101000011011010011001011001001111101101100111101
1100100001011001110101010110000011111011000111100001
1011110100101100001110001100010100000000100001110011
1001010011001100010111000100011011000000010011110111
1001101000111000110101001100111101000000101111110001
1001110111010010110110001111100011010100101100011111
1100010011101100001011000110110111101000010111111101
1000111101001010011001010001101100101101010101111111
1101101011100101011001001111100110001001010000101011
1101100101011100011000001010110101010110000010010011
1101110001000000010101110000100100111000011000010111
1101111001011100101001011001110110100101110000111011
1100100111010001110010010010100100010011001010011001
1110011110001000110011000101010110111010010001111001
1100010011011010011111001000011111000000011111111111
1010011000110110101001101011011100101001100110001111
1110011100101011101010101101110001010001001011001111
1010001101101100011010110000001100110000111000100001
1111100110011011000011111011011111011101001010011001
1011111111110001011110110111001111111000111011111101
1010100101001110111110010001101001001010111010001101
1010111010100111010000010111000000110001110110000101
1010011100110101111111111001110011001111100001111011
1011011110110100111110010100110011001000111011000011
1011101110110001100110011010100000101010101010101001
1011110001001111010001101100101101000001111111001011
1110001010100101000011100110010001010110011110110011
1111111111111111111111111111111111111111111111111111
